XXXXXXXXXXXXXXXXXXXXXXXXXXXXXXXXXXXXXXXXXXXXXXXXXXXXXXXXXXXXXXXXXXXXXXXXXXXXXXXXXXXXXXXXXXXXXXXXXXXXXXXXXXXXXXXXXXXXXXXXXXXXXXXXXXXXXXXXXXXXXXXXXXXXXXXXXXXXXXXXXXXXXXXXXXXXXXXXXXXXXXXXXXXXXXXXXXXXXXXXXXXXXXXXXXXXXXXXXXXXXXXXXXXXXXXXXXXXXXXXXXXXXXXXXXXXXXXXXXXXXXXXXXXXXXXXXXXXXXXXXXXXXXXXXXXXXXXXXXXXX
P         X         X       X           X                 X   X           X     X       X   X                   X             X               X     X       X             X   X           X   X           X       X   X     X   X X         X X         X             X         X         X           X     X
X XXXXXXX X XXXXXXX X XXXXX XXX XXXXXXX X XXXXXXXXXXXXXXX X X X XXXXXXX X XXX X X XXX X XXX X XXXXXXXXXXX XXXXX XXX X XXXXXXX XXXXX XXXXXXX X X XXX XXXXX X XXX XXXXXXX X X X X XXXXXXX X X X XXXXX XXX X XXXXX X X X X XXX X X X X XXX XXX X X X XXXXX XXXXXXXXX XXX X XXXXX X X XXXXXXX X XXXXXXX X X XXX X
X   X   X   X     X   X   X X   X X   X X X       X   X   X X       X   X X   X X   X X     X X       X X     X     X X     X     X   X     X   X   X   X X   X X     X X   X         X X   X     X X   X       X   X X   X   X   X X X   X X   X X   X   X     X   X X X   X X X X     X X       X X   X   X
XXX X X XXXXX XXX XXXXXXX X X XXX X X X X XXXXX X X X X XXXXX XXXXXXX XXX X XXXXXXX X XXXXX X XXXXX X X XXXXX XXXXXXX X XXX XXXXX XXXXX XXXXXXXXX XXX X X XXX X X XXX XXXXXXX XXXXXXX X XXXXXXXXX XXX XXXXXXXXXXXXXXX XXX XXXXX XXX X XXX X X XXX X XXXXX X XXX XXX X X X X X X X XXX XXX XXX XXXXX XXXXX XXX
X   X X     X X   X       X X X   X X   X X     X   X X     X X       X   X X       X   X X X   X   X   X   X   X   X X   X X   X       X X       X   X   X X X X X X       X X X   X X     X         X       X     X   X   X   X       X X X   X X         X   X   X     X X X X   X   X     X   X X     X X
X XXX XXXXX X X XXX X XXXXX X X X X XXXXX X XXXXXXXXX XXXXX XXX XXXXXXX XXX X XXXXXXXXX X X XXX X XXXXX X X XXX X X XXX XXX X XXXXXXXXXXX X XXXXXXX XXXXXXX X XXX X XXXXXXX X X X X XXXXXXX XXXXXXXXXXX X XXXXX X XXXXX X X XXXXX XXXXXXX X XXXXX XXXXXXXXXXX XXXXX XXXXXXX X X XXX XXX XXXXXXX X X X XXXXX X
X     X   X   X   X X   X   X X X   X     X X         X   X   X   X     X   X X     X   X   X   X X X   X X   X   X     X   X     X     X X X       X       X     X X       X   X X       X   X   X X   X X     X X   X X X       X     X X       X     X     X   X   X   X X X   X       X   X X   X X   X X
X XXXXX X XXXXXXX XXXXX X XXX X XXXXXXX XXX XXXXXXXXXXX X XXX XXX X XXXXX X X XXXXX X XXXXXXX XXX X X XXX XXX XXXXXXXXXXX XXX X X X X X X X XXX XXXXX XXXXX XXXXXXX X XXXXXXXXX X XXXXXXX X X X X X X XXX X XXXXX X X X X XXXXXXXXX XXX X XXXXXXXXX XXX XXX XXX X XXXXX X XXX X XXXXXXXXX XXX X XXXXX X X X X
X     X X       X   X   X X   X   X     X   X       X   X   X     X   X   X         X X       X   X X   X   X X         X X X X X X X X   X   X X     X     X       X X       X X   X     X X X X X X X X       X X X   X   X   X   X   X       X     X   X X   X       X X   X X       X X   X X     X X X X
XXXXX XXXXXXXXX XXX X X X X X XXX X XXXXX X X XXXXX X XXXXX XXXXXXXXX XXX XXXXXXXXX X X XXXXXXXXX X XXX XXX X X XXXXXXX X X X X XXX X XXXXXXX X XXX XXXXXXXXX XXX XXX XXX XXXXX XXX XXX XXX X X X X X X XXXXXXXXX X XXXXX XXX X X XXX XXX XXXXX X XXXXXXX X X XXXXXXXXXXX X XXXXX XXX XXX X XXX X XXXXX X X X
X   X     X       X X X X X X   X   X   X X       X   X   X   X     X   X X   X   X X     X       X   X   X X X     X     X   X     X     X   X   X         X X   X   X   X   X   X   X X   X   X X X X     X     X   X X X   X X X X X X X X   X X       X   X         X X         X X   X X   X       X X X
X XXXXXXX X XXXXXXX X XXX X XXX XXXXXXX X XXXXXXX XXXXX X X X XXX X XXX X X X X X XXXXXXX X X XXXXXXX XXX XXX XXXXX XXXXXXX XXXXXXXXXXXXX X XXX X XXX XXXXX X X XXX XXX XXX X XXX XXX X XXXXXXXXX X X X XXX X XXX XXX X X X XXX X X X X X X X X X X XXXXXXXXXXXXXXX X XXX XXXXXXXXXXX X XXX X XXXXXXXXXXX X X
X       X   X       X X   X   X X       X X X   X X   X X X X     X X   X   X X X       X X X X     X   X X   X   X     X   X     X   X   X X   X   X     X X X X   X   X   X   X   X X X   X     X     X   X X   X   X   X   X   X   X     X X X X X           X   X X   X           X X   X X   X     X   X
XXX XXXXXXX X XXXXXXX X XXXXX X X X XXX X X X X XXX X X X X XXXXXXX X XXXXX XXX XXXXXXX X XXX X XXX X X X X X X X XXXXX X XXXXX XXX X X XXX X XXXXX XXXXX X X X X XXXXX X XXX X XXX X X X X X XXX XXXXXXX XXX XXX X XXXXXXXXX XXXXX XXXXXXXXX XXX X X XXXXXXXXX X X XXX XXX XXXXXXXXX X XXX X X X X XXXXXXX X
X   X   X   X   X           X X X X X X X   X X     X   X   X     X X X   X X   X     X X   X X X   X X     X X X       X     X   X X X     X     X X   X X   X   X   X   X   X X   X X   X   X   X     X X X   X X     X     X     X       X     X X X       X X X X   X       X     X   X X X X X         X
X XXX X X XXXXX XXXXXXXXXXX XXX XXX X X XXX X XXXXX XXXXXXX X XXX X X X X XXX XXXXX XXX XXX X X XXX XXXXXXXXX X XXXXXXXXXXXXX X X X X XXXXXXXXXXX X X X X XXXXXXXXX X X XXX XXX X XXX XXXXXXXXX XXX XXX X X XXX X XXXXX X XXXXX XXXXX XXXXX X XXXXX X XXXXX XXX X X X XXXXXXX X XXX XXXXX X X X X X XXXXXXXXX
X X   X   X   X       X   X   X   X X X X   X     X X   X   X   X X X   X     X     X   X     X   X       X   X   X X     X X X X   X           X X X X X X         X X X X X   X   X         X X     X X   X X X     X   X   X       X X   X X     X X   X       X X       X X   X X   X X X   X X X     X X
X X XXXXX X XXXXXXXXX X X XXX XXX X X X X XXXXXXX XXX X XXXXXXX X XXXXXXXXXXXXXXX X X XXXXXXXXXXX XXXXXXX XXXXXXX X X X X X X XXX XXXXXXX XXXXX XXX X XXX XXX XXXXXXX X X X XXXXXXX XXXXXXXXX XXX XXXXX XXX X X XXXXXXXXXXX X XXXXXXXXX X XXXXX XXXXX X X XXXXXXXXX XXXXXXX X XXX XXX X X X XXXXX X XXX X X X
X X X   X   X         X X   X     X X   X X     X   X X       X X     X           X X           X       X X     X X   X X   X   X       X X         X         X     X X   X   X   X X       X X   X     X     X         X   X     X   X X     X X       X         X X       X X X X   X X   X   X X     X   X
X X X X XXXXX XXXXXXXXX XXX XXXXXXX XXXXX X XXX XXX X XXXXXXX X XXX X XXX XXXXXXXXXXXXXXXXXXXXX X XXXXX X X XXX X X XXX XXXXXXX XXXXXXXXX X XXXXXXXXXXXXXXXXXXXXXXX X XXX XXX X X X X X XXX X X XXX XXXXXXXXX XXXXXXX X X XXXXXXX X X X XXXXX X XXX XXXXXXXXXXXXX XXX XXXXXXX X X X XXX XXX XXX X XXXXXXXXX X
X   X X   X   X   X       X       X       X X       X X   X X     X X X   X             X       X X   X X   X X X X   X   X     X   X     X X     X       X       X X X X X X   X   X X X   X X   X   X     X   X     X X   X   X   X     X X X   X           X X     X X   X   X   X X   X X   X   X   X   X
X XXX XXX X XXX X XXXXXXXXX XXX XXX XXXXXXX X XXXXXXX X X X XXXXXXX X X XXX XXXXXXXXX X X XXXXXXX X X X XXXXX X X XXX XXX X XXXXX X X XXX XXX XXX X XXXXX X XXXXX X X X X X XXXXXXXXXXX X XXX X XXXXX X XXX XXXXX XXXXX XXX X XXXXXXXXXXX X X X X XXXXXXXXXXX X XXXXXXX X X XXX XXXXX X XXX X X XXX X X X XXX
X   X   X   X   X   X     X   X X     X   X X   X     X X   X X     X   X   X       X X X     X   X X   X     X X   X   X   X     X X   X X   X   X X X   X   X   X   X     X     X     X   X   X     X   X X     X         X   X       X   X X X X         X X         X X     X X   X       X   X X X X X X
XXX XXX XXXXX X XXX X XXX XXXXX X XXXXX X X XXX X XXXXX XXX X X XXX XXXXX XXX XXX XXX XXXXXXX XXXXX XXXXX X XXX X X X XXXXX X XXXXX XXX XXX XXX XXX X X XXXXX X XXXXX XXXXX X XXX XXX XXXXX XXXXX XXXXXXX X X XXXXX XXXXXXXXX X X XXX XXXXX X XXX X XXXXXXX X XXX XXXXXXX XXXXXXX X X XXXXXXXXXXX X X XXX X X
X     X X     X   X   X         X X X   X   X X X   X X   X   X X   X   X X     X   X     X   X   X X     X     X X X X   X X X   X     X   X X X   X X       X     X   X X   X       X   X X     X     X X   X   X X       X X     X X     X X   X   X   X X   X       X   X     X X   X     X   X X   X X X
X XXXXX XXXXXXXXX X XXXXXXXXX XXX X X XXXXXXX X XXX X X X X XXX X XXX X X XXXXX XXX XXXXX X XXX X X XXXXXXXXXXX X X XXX X X X X X XXXXX X XXX X X XXX XXXXX XXXXXXX XXX X XXXXX XXXXXXX X X X XXXXX XXX X XXXXX X X X XXXXX XXXXXXX X X XXXXX X XXXXX X X X XXX X XXXXX XXX XXX XXX XXX X XXX XXXXX XXX X X X
X   X   X     X   X X       X X   X X X         X X X   X X X   X X   X   X   X   X     X X     X X           X X X     X X   X X       X   X X X     X   X   X     X   X       X     X X X X         X X   X   X   X X   X X     X X     X   X X     X X X     X   X X   X   X     X   X   X     X X   X   X
XXXXX XXX XXX X XXX X XXXXX XXX XXX X XXX XXXXXXX X XXX X X X XXX X XXXXXXX X X XXXXX X X XXXXXXX X XXXXXXXXX X XXXXXXX X XXXXXXXXXXXXXXXXX X X XXXXX X X XXX X XXXXX XXXXXXXXXXX XXX X X XXXXX XXXXXXX XXX XXXXXXXXX X X X X XXX XXXXX XXX XXX X XXXXX X XXXXXXXXX X XXX XXX XXXXXXX X XXX XXXXX X X XXXXX X
X     X   X     X   X X X   X   X   X   X         X   X X X X X   X X       X X X   X X X         X X X     X X   X   X X                 X   X       X X X   X X   X         X   X X   X     X X     X   X X         X X X   X   X   X X   X   X   X   X     X X   X   X             X X   X   X X X       X
X XXXXX XXXXXXXXX XXX X X X X XXXXX XXX XXX XXXXXXXXX XXX XXX XXX X X XXXXXXX X X X X X XXXXXXXXXXX X X XXX X XXX X X XXXXXXXXX XXXXXXXXX XXX XXXXXXXXX X XXXXX X X XXXXXXXXX X XXX XXXXXXXXX XXX XXX XXX X X XXXXXXXXX X XXXXX XXX X XXX XXX X XXX X XXXXXXX X X XXXXX XXXXXXXXXXXXXXXXX XXXXX X X X XXXXXXX
X     X       X X X X   X X X     X   X   X X   X   X   X   X   X X   X       X X X   X X         X X   X   X X     X         X     X       X X       X X X   X   X X           X           X   X X       X   X     X   X     X   X X     X   X X   X X X     X               X       X   X   X     X X   X X
XXXXX XXXXXXX X X X XXX X XXXXXXX X X XXX XXX X X X XXX XXX XXX XXXXXXX XXXXXXX X XXXXXXX X XXXXX X XXXXX X X XXXXXXXXXXXXXXX XXXXX X XXXXXXX X XXXXX X X X X XXX X X XXXXXXXXXXXXXXX X X XXXXX X XXXXXXXXX XXXXXXX X XXX XXXXXXX X XXXXXXX XXX X XXX X X XXXXXXXXXXXXXXXXXXX X XXXXX X XXX X XXXXXXX X X X X
X   X     X X X   X   X X         X X   X   X X   X     X     X     X   X     X X       X X X     X X   X X X   X           X     X X         X     X   X   X   X X X X     X   X   X X X X     X   X     X       X X   X       X   X       X X X     X X             X   X   X     X X X   X   X   X X X   X
X XXXXXXX X X XXX XXX X XXXXXXXXXXXXX XXXXX X XXXXXXXXXXX XXX XXX XXX XXX X X X XXXXXXX X X XXXXX X X X X X XXX X X XXXXX XXXXXXX X XXXXXXXXX XXXXX XXXXXXXXXXX X X XXX XXX X X X X XXX XXX XXXXXXX X X XXXXXXXXX X XXX XXXXXXX XXXXXXX XXXXX X XXXXXXX XXXXXXXXXXXXX XXX X XXXXXXX X X X XXXXX XXX X X XXX X
X       X   X   X     X     X       X X     X   X     X     X X X     X   X X X X     X   X     X X   X   X   X X X   X   X     X X   X X   X X   X           X X X     X X   X   X   X     X     X X X         X X   X X X           X X     X X X           X X   X   X       X   X X X   X X   X   X   X X
X XXXXX XXXXXXX X XXXXXXXXX XXXXX X X X XXX XXX XXX X XXXXX X X XXXXXXX XXX X XXX XXX X XXXXXXX X XXXXXXXXX XXX X XXX X XXX XXX X XXX X X X XXX X X XXXXXXXXX X X XXXXXXX XXXXXXXXXXX X XXXXX XXX X X XXXXX XXX X X X X X X XXXXXXXXX X XXX XXX X X XXXXXXX X X X X XXX XXXXXXXXX XXX X XXX X XXX X XXX X XXX
X     X X       X X   X   X X     X   X X   X X X   X       X X   X     X   X     X   X     X   X     X     X   X   X X   X   X X X     X X     X X   X   X   X X   X     X           X X     X   X X   X X X   X X X X   X X       X X   X X   X   X   X   X   X X   X       X   X X X     X   X X X   X   X
XXXXXXX X X XXXXXXX X X X X X XXX XXXXX X XXX X X XXXXXXXXXXX X XXX XXXXX XXXXXXXXX XXXXXXXXX XXXXXXX X XXXXX XXXXX X XXXXX XXX X X XXXXX XXXXXXX XXX X XXX XXX XXX X X XXX XXXXXXXXXXX X XXX X XXX XXX X X XXXXX X X XXX X X X X XXX XXX X X XXXXXXX X X X XXXXX XXX XXXXXXX X XXX X XXX XXX X X X XXXXXXX X
X       X X       X X   X   X   X X     X   X X X       X   X X X       X   X     X         X   X     X     X X   X X X     X   X X   X   X X   X X   X   X X     X   X X   X         X X X   X X     X   X       X X X   X X X X X   X     X         X X X X     X X       X X   X     X     X X X         X
X XXXXX X XXXXXXX X XXXXXXXXX X X X XXXXXXX X X X XXXXX X X X X X XXXXXXX X X XXX XXXXXXXXX X X XXX XXXXXXX X X X XXX X XXXXX X X X XXX XXX X X X X XXXXX X XXXXX XXXXX X XXX XXXXX XXX X X XXX X XXX XXX XXXXXXXXX X X XXX XXX XXX XXXXXXXXXXXXXXXXXXX X XXX XXXXX XXXXX X X X X XXXXX XXXXXXX X XXXXXXXXX X
X X     X   X   X   X     X   X X X X   X X X X X     X X X X X X   X   X X     X   X     X X X   X     X   X X X     X X   X X X X X   X     X   X       X     X X   X X   X   X X     X X X   X X   X X     X     X     X   X   X             X       X       X   X     X X X X X   X X       X X X   X   X
X XXXXXXXXX X X XXXXX XXXXX XXX X X X X X X X X XXXXXXX XXX X X X XXX X XXXXXXX XXX X XXX X X XXX XXXXX XXX X X XXXXX X XXX X X X XXX XXX XXXXXXXXXXXXXXX XXXXX X X X X XXX XXX X XXXXXXXXX X XXXXX XXX XXXXX XXX XXXXXXXXXXX X X XXXXXXXXXXXXX X XXXXXXXXXXXXX XXX X XXXXXXX X X X X X XXXXXXXXX X X X X XXX
X   X     X   X     X       X   X X   X X   X X   X     X   X X   X   X     X X   X X X   X X X   X   X   X X X   X   X     X X X     X X       X       X     X X   X X   X   X X           X       X X     X   X X   X       X X             X X   X       X     X X X       X X   X X X         X X X   X X
X X X X XXXXXXXXXXX X XXXXXXX XXXXXXXXX XXX X XXX X XXXXX XXX X XXX XXXXXXX X XXX X X X XXX XXX XXX X XXX XXX XXX X XXXXX XXX X XXXXXXX XXXXXXX X X XXX XXXXXXX XXXXX XXXXXXX X XXX XXXXXXXXXXXXXXXXX X X XXXXX X X X X XXXXXXX XXX XXXXXXX XXX X X X XXXXX XXXXX X X X XXXXXXX XXXXX X X XXXXXXXXX X XXXXX X
X X X X   X       X X   X   X         X   X   X   X   X X     X   X X X   X X     X X X   X     X   X   X X   X   X   X   X   X   X       X     X X X X     X   X   X       X X     X         X       X X     X X X X   X     X X X X       X   X X       X     X   X   X     X   X   X X X   X     X X   X X
X X X XXX X X XXXXX XXXXX X XXXXXXX X XXX XXXXX XXXXX X X XXXXXXXXX X X X X XXXXXXX X XXX XXXXXXX XXXXXXX X XXX XXXXXXX XXX XXXXXXX XXX XXX XXXXXXX X XXXXX X XXX X XXXXXXX X XXXXXXX XXX XXXXX X XXXXX XXX XXX XXX XXXXX X XXX X X XXXXXXXXX XXXXXXXXXXXXXXXXX XXX XXXXX XXX XXXXX XXX X X X X X XXX X X X X
X X     X   X             X         X   X             X             X   X           X   X                   X             X           X             X         X   X           X         X       X         X         X     X       X                             X         X         X     X X   X       X   K
XXXXXXXXXXXXXXXXXXXXXXXXXXXXXXXXXXXXXXXXXXXXXXXXXXXXXXXXXXXXXXXXXXXXXXXXXXXXXXXXXXXXXXXXXXXXXXXXXXXXXXXXXXXXXXXXXXXXXXXXXXXXXXXXXXXXXXXXXXXXXXXXXXXXXXXXXXXXXXXXXXXXXXXXXXXXXXXXXXXXXXXXXXXXXXXXXXXXXXXXXXXXXXXXXXXXXXXXXXXXXXXXXXXXXXXXXXXXXXXXXXXXXXXXXXXXXXXXXXXXXXXXXXXXXXXXXXXXXXXXXXXXXXXXXXXXXXXXXXXXX
